0 7 0 0 7 7 0 0 1 0 0 7 7
6 6 0 6 6 0 1 0 0 0 2 0 0
1 1 7 0 6 0 1 1 0 1 1 1 0
7 7 2 0 6 0 7 1 1 2 1 0 0
1 1 1 2 6 0 7 0 1 2 6 6 2
7 7 7 1 0 2 7 0 7 0 6 2 1
6 0 1 1 0 7 7 1 7 0 2 0 1
2 2 0 7 6 6 6 0 7 1 0 1 1
2 0 1 0 0 0 0 1 0 1 2 1 2
0 0 1 1 7 0 0 0 0 7 0 7 6
0 0 0 1 0 7 7 7 0 0 0 1 6
7 1 1 0 0 1 1 1 7 7 2 7 7
0 7 7 0 0 1 5 1 0 0 2 0 0