0 0 0 0 0 0 0 0 0 0 0 0 0
0 1 1 1 0 3 3 0 0 0 1 1 0
1 0 0 1 3 3 3 3 1 1 0 0 1
1 0 0 1 3 2 2 3 1 1 0 0 1
1 0 1 4 4 4 4 4 4 4 1 0 1
0 1 1 1 2 2 1 2 2 1 1 1 0
0 1 1 1 2 0 1 0 2 1 1 1 0
0 1 1 1 0 0 1 0 0 1 1 1 0
0 0 1 1 1 1 1 1 1 1 1 1 0
1 3 0 1 1 2 2 1 1 0 0 3 1
1 3 3 3 3 3 3 3 3 3 3 3 1
0 0 3 3 3 1 1 1 3 3 3 3 0
0 0 0 1 0 1 5 1 0 0 1 0 0